+--+--+--+--+--+--+
|                 |
+  +--+--+  +  +  +
|  |     |  |  |  |
+  +  +  +  +  +  +
|     |     |     |
+--+  +--+  +  +--+
|        |        |
+  +--+  +  +--+  +
|  |     |     |  |
+  +  +--+--+  +  +
|              | g|
+--+--+--+--+--+--+
