+--+--+--+--+--+--+--+--+
|                       |
+  +--+--+  +--+--+  +  +
|  |     |  |     |  |  |
+  +  +  +  +  +  +  +  +
|  |  |  |  |  |  |  |  |
+  +  +  +  +  +  +  +  +
|  |  |     |  |     |  |
+  +  +--+--+  +--+  +  +
|  |           |     |  |
+  +--+  +--+  +  +--+  +
|     |  |     |        |
+  +  +  +  +--+--+--+  +
|  |  |  |           |  |
+  +  +  +--+--+  +  +  +
|  |  |        |  |  |  |
+  +  +--+--+  +  +  +  +
|  |        |  |  |     |
+  +--+--+  +  +  +--+--+
|        |     |       g|
+--+--+--+--+--+--+--+--+
